5
5
2
#####
#@x^#
##x##
# ^ #
#####