8
9
100
  ##### 
###   # 
#^@x  # 
### x^# 
#^##x # 
# # ^ ##
#x Xxx^#
#   ^  #
########